"Year","State","TOTAL.POPULATION","TOTAL.FREE.POPULATION","AGGR..HALF.BREED.PERSONS","FOREIGN.BORN.BLACK.MALES","FOREIGN.BORN.BLACK.FEMALES","TOTAL.FOREIGN.BORN.BLACK.PERSONS","FOREIGN.BORN.MULATTO.MALES","FOREIGN.BORN.MULATTO.FEMALES","TOTAL.FOREIGN.BORN.MULATTO.PERSONS","TOTAL.NATIVE.BORN.MULATTO.PERSONS","NATIVE.BORN.MULATTO.FEMALES","NATIVE.BORN.BLACK.MALES","NATIVE.BORN.BLACK.FEMALES","TOTAL.NATIVE.BORN.BLACK.PERSONS","NATIVE.BORN.MULATTO.MALES","AGGR..FREE.COLORED.PERSONS","TOTAL.FREE.COLORED.MALES","TOTAL.FREE.COLORED.FEMALES","AGGR..SLAVES","TOTAL.MALE.SLAVES","TOTAL.FEMALE.SLAVES","Type"
1860,"ALABAMA",964201,529121,NA,NA,NA,NA,NA,NA,NA,2098,1138,293,297,590,960,2690,1254,1436,435080,217766,217314,"State"
1860,"ARKANSAS",435450,324335,NA,NA,NA,NA,NA,NA,NA,86,45,30,27,57,41,144,72,72,111115,56174,54941,"State"
1860,"CALIFORNIA",379994,379994,NA,208,41,249,156,46,202,1338,490,1615,682,2297,848,4086,2827,1259,NA,NA,NA,"State"
1860,"CONNECTICUT",460147,460147,NA,76,31,107,24,9,33,1862,993,3167,3458,6625,869,8627,4136,4491,NA,NA,NA,"State"
1860,"DELAWARE",112216,110418,NA,2,3,5,NA,NA,NA,2896,1446,8437,8491,16928,1450,19829,9889,9940,1798,860,938,"State"
1860,"FLORIDA",140424,78679,NA,10,12,22,4,3,7,636,322,126,141,267,314,932,454,478,61745,31348,30397,"State"
1860,"GEORGIA",1057286,595088,NA,8,13,21,6,1,7,1997,1066,724,751,1475,931,3500,1669,1831,462198,229193,233005,"State"
1860,"ILLINOIS",1711951,1711951,NA,17,15,32,18,20,38,3555,1792,2011,1992,4003,1763,7628,3809,3819,NA,NA,NA,"State"
1860,"INDIANA",1350428,1350428,NA,3,4,7,5,2,7,5440,2756,3099,2875,5974,2684,11428,5791,5637,NA,NA,NA,"State"
1860,"IOWA",674913,674913,NA,2,2,4,6,1,7,561,276,273,224,497,285,1069,566,503,NA,NA,NA,"State"
1860,"KANSAS",107206,107204,NA,0,0,0,1,0,1,265,146,166,193,359,119,625,286,339,2,0,2,"Territory"
1860,"KENTUCKY",1155684,930201,NA,2,3,5,1,1,2,4075,2198,3221,3381,6602,1877,10684,5101,5583,225483,113009,112474,"State"
1860,"LOUISIANA",708002,376276,NA,44,82,126,123,177,300,14858,8140,1394,1969,3363,6718,18647,8279,10368,331726,171977,159749,"State"
1860,"MAINE",628279,628279,NA,37,30,67,31,38,69,565,288,314,312,626,277,1327,659,668,NA,NA,NA,"State"
1860,"MARYLAND",687049,599860,NA,22,32,54,17,22,39,16001,8779,32485,35363,67848,7222,83942,39746,44196,87189,44313,42876,"State"
1860,"MASSACHUSETTS",1231066,1231066,NA,188,219,407,105,99,204,2867,1558,2867,3257,6124,1309,9602,4469,5133,NA,NA,NA,"State"
1860,"MICHIGAN",749113,749113,NA,168,184,352,72,59,131,3244,1591,1674,1398,3072,1653,6799,3567,3232,NA,NA,NA,"State"
1860,"MINNESOTA",172023,172023,NA,0,0,0,7,5,12,157,77,39,51,90,80,259,126,133,NA,NA,NA,"State"
1860,"MISSISSIPPI",791305,354674,NA,1,1,2,0,0,0,601,309,79,91,170,292,773,372,401,436631,219301,217330,"State"
1860,"MISSOURI",1182012,1067081,NA,4,0,4,7,5,12,1662,897,921,973,1894,765,3572,1697,1875,114931,57360,57571,"State"
1860,"NEBRASKA",28841,28826,NA,1,2,3,0,0,0,39,18,13,12,25,21,67,35,32,15,6,9,"Territory"
1860,"NEVADA",6857,6857,NA,1,0,1,2,1,3,15,1,18,8,26,14,45,35,10,NA,NA,NA,"Territory"
1860,"NEW HAMPSHIRE",326073,326073,NA,2,0,2,3,0,3,250,123,121,118,239,127,494,253,241,NA,NA,NA,"State"
1860,"NEW JERSEY",672035,672017,NA,40,28,68,10,11,21,3432,1847,10677,11120,21797,1585,25318,12312,13006,18,6,12,"State"
1860,"NEW YORK",3880735,3880735,NA,1480,1838,3318,199,183,382,7399,3911,18011,19895,37906,3488,49005,23178,25827,NA,NA,NA,"State"
1860,"NORTH CAROLINA",992622,661563,NA,1,1,2,7,0,7,21801,11204,4275,4378,8653,10597,30463,14880,15583,331059,166469,164590,"State"
1860,"OHIO",2339511,2339511,NA,44,32,76,33,20,53,16638,8500,10227,9679,19906,8138,36673,18442,18231,NA,NA,NA,"State"
1860,"OREGON",52465,52465,NA,4,0,4,1,0,1,61,30,40,22,62,31,128,76,52,NA,NA,NA,"State"
1860,"PENNSYLVANIA",2906215,2906215,NA,110,71,181,87,74,161,18981,10436,17731,19895,37626,8545,56949,26473,30476,NA,NA,NA,"State"
1860,"RHODE ISLAND",174620,174620,NA,32,26,58,10,4,14,983,531,1337,1560,2897,452,3952,1831,2121,NA,NA,NA,"State"
1860,"SOUTH CAROLINA",703708,301302,NA,0,3,3,0,2,2,7132,3847,1263,1514,2777,3285,9914,4548,5366,402406,196571,205835,"State"
1860,"TENNESSEE",1109801,834082,NA,1,3,4,3,1,4,4288,2269,1515,1489,3004,2019,7300,3538,3762,275719,136370,139349,"State"
1860,"TEXAS",604215,421649,NA,0,4,4,16,1,17,256,127,36,42,78,129,355,181,174,182566,91189,91377,"State"
1860,"VERMONT",315098,315098,NA,8,7,15,6,4,10,182,93,268,234,502,89,709,371,338,NA,NA,NA,"State"
1860,"VIRGINIA",1596318,1105453,NA,2,0,2,2,1,3,23482,12411,16646,17909,34555,11071,58042,27721,30321,490865,249483,241382,"State"
1860,"WISCONSIN",775881,775881,404,8,4,12,8,6,14,723,333,247,175,422,390,1171,653,518,NA,NA,NA,"State"
